Archipelago Version 0.6.1  -  Seed: 1

Filling Algorithm:               balanced
Players:                         1
Plando Options:                  connections, texts, bosses
Game:                            Terraria
Progression Balancing:           50
Accessibility:                   Full
Local Items:                     
Non-local Items:                 
Start Inventory:                 
Start Hints:                     
Start Location Hints:            
Excluded Locations:              
Priority Locations:              
Item Links:                      
Goal:                            Mechanical Bosses
Achievements:                    Exclude Grindy
Fill Extra Checks With:          Useful Items
Death Link:                      No


Locations:

Copper Shortsword: Copper Shortsword
Guide: Guide
Timber!!: Reward: Titan Glove
Benched: Reward: Obsidian Rose
Stop! Hammer Time!: Reward: Neptune's Shell
Matching Attire: Reward: Yoyo Glove
Fashion Statement: Reward: Black Belt
Ooo! Shiny!: Post-Queen Bee
No Hobo: Reward: Gold Ring
Merchant: Merchant
Bug Net: Bug Net
Heavy Metal: Reward: Hermes Boots
Nurse: Nurse
The Frequent Flyer: Reward: Demon Conch
Demolitionist: Demolitionist
Dye Trader: Dye Trader
Dye Hard: Reward: Shoe Spikes
Lucky Break: Reward: DPS Meter
Star Power: Post-Deerclops
You Can Do It!: Post-Goblin Army
Aglet: Aglet
Heliophobia: Reward: Celestial Magnet
Zoologist: Zoologist
Cat: Cat
Feeling Petty: Reward: Lava Charm
Dog: Dog
Enchanted Sword: Enchanted Sword
Angler: Angler
Water Walking Boots: Water Walking Boots
Painter: Painter
Into Orbit: Reward: Feral Claws
Starfury: Starfury
Watch Your Step!: Post-Evil Boss
Throwing Lines: Reward: Grappling Hook
Torch God: Reward: Rifle Scope
Vehicular Manslaughter: Reward: Flipper
Hey! Listen!: Reward: Ancient Chisel
I Am Loot!: Post-King Slime
Heart Breaker: Reward: Megaphone
Hold on Tight!: Reward: Fisherman's Pocket Guide
Gold Hammer: Gold Hammer
Gold Pickaxe: Gold Pickaxe
Like a Boss: Reward: Moon Charm
Hermes Boots: Hermes Boots
Jeepers Creepers: Reward: Star Cloak
Stylist: Stylist
Funkytown: Post-Pirate Invasion
Dead Men Tell No Tales: Post-Skeletron
Obsidian: Obsidian
Obsidian Skull: Obsidian Skull
Lava Charm: Lava Charm
Demonite Ore: Demonite Ore
Demonite Bar: Demonite Bar
Evil Sword: Evil Sword
Ice Skates: Ice Skates
Flinx Fur Coat: Flinx Fur Coat
Golfer: Golfer
Anklet of the Wind: Anklet of the Wind
Stinger: Stinger
Jungle Spores: Jungle Spores
Vine: Vine
Blade of Grass: Blade of Grass
Summoning Potion: Summoning Potion
It's Getting Hot in Here: Reward: Ice Skates
Rock Bottom: Reward: Paint Sprayer
Obsidian Rose: Obsidian Rose
Smashing, Poppet!: Reward: Climbing Claws
Arms Dealer: Arms Dealer
Leading Landlord: Reward: Magic Mirror
Completely Awesome: Reward: Trifold Map
King Slime: Reward: Putrid Scent
The Cavalry: Hardmode
Solidifier: Solidifier
Sandstorm: Sandstorm
Quiet Neighborhood: Reward: Armor Polish
Eye of Cthulhu: Reward: Rod of Discord
Dryad: Dryad
Pumpkin Seeds: Pumpkin Seeds
Pumpkin: Pumpkin
Purification Powder: Purification Powder
Party Girl: Party Girl
Evil Boss: Reward: Magic Conch
Evil Boss Part: Evil Boss Part
Evil Pickaxe: Evil Pickaxe
Obsidian Armor: Obsidian Armor
Tavernkeep: Tavernkeep
Old One's Army Tier 1: Reward: Flying Carpet
Meteorite: Meteorite
Meteorite Bar: Meteorite Bar
Meteor Hamaxe: Meteor Hamaxe
Hellforge: Hellforge
Hellstone: Hellstone
Hellstone Bar: Hellstone Bar
Fiery Greatsword: Fiery Greatsword
Molten Hamaxe: Molten Hamaxe
Molten Pickaxe: Molten Pickaxe
Miner for Fire: Reward: Stopwatch
Hot Reels!: Reward: Red Counterweight
Goblin Army: Post-Eye of Cthulhu
Goblin Tinkerer: Goblin Tinkerer
Tinkerer's Workshop: Tinkerer's Workshop
Rocket Boots: Rocket Boots
Spectre Boots: Spectre Boots
Lightning Boots: Lightning Boots
Frostspark Boots: Frostspark Boots
Lava Waders: Lava Waders
Terraspark Boots: Terraspark Boots
Where's My Honey?: Post-Old One's Army Tier 1
Queen Bee: Reward: Fledgling Wings
Bee Keeper: Bee Keeper
Bee Wax: Bee Wax
Bee Armor: Bee Armor
Not the Bees!: Reward: Nature's Gift
Witch Doctor: Witch Doctor
Pygmy Necklace: Pygmy Necklace
Skeletron: Reward: Tally Counter
Clothier: Clothier
Dungeon: Dungeon
Dungeon Heist: Reward: Weather Radio
Bone: Bone
Bewitching Table: Bewitching Table
Mechanic: Mechanic
Wire: Wire
Actuator: Actuator
Muramasa: Muramasa
Deerclops: Reward: Lavaproof Fishing Hook
Night's Edge: Night's Edge
Wall of Flesh: Reward: Sextant
Pwnhammer: Pwnhammer
Wizard: Wizard
Tax Collector: Tax Collector
Spider Fangs: Spider Fangs
Spider Armor: Spider Armor
Cross Necklace: Cross Necklace
Altar: Altar
Begone, Evil!: Reward: Step Stool
Cobalt Ore: Cobalt Ore
Extra Shiny!: Reward: Cloud in a Bottle
Cobalt Bar: Cobalt Bar
Cobalt Pickaxe: Cobalt Pickaxe
Soul of Night: Soul of Night
Hallow: Hallow
Pixie Dust: Pixie Dust
Unicorn Horn: Unicorn Horn
Crystal Shard: Crystal Shard
Soul of Light: Soul of Light
Blessed Apple: Blessed Apple
Rod of Discord: Rod of Discord
Soul of Flight: Soul of Flight
Head in the Clouds: Reward: Fast Clock
Bunny: Bunny
Forbidden Fragment: Forbidden Fragment
Don't Dread on Me: Post-Queen Slime
Truffle: Truffle
It Can Talk?!: Reward: Lucky Coin
Pirate Invasion: Reward: Water Walking Boots
Pirate: Pirate
Queen Slime: Reward: Torch God's Favor
Mythril Ore: Mythril Ore
Mythril Bar: Mythril Bar
Hardmode Anvil: Hardmode Anvil
Mythril Pickaxe: Mythril Pickaxe
Adamantite Ore: Adamantite Ore
Hardmode Forge: Hardmode Forge
Adamantite Bar: Adamantite Bar
Adamantite Pickaxe: Adamantite Pickaxe
Forbidden Armor: Forbidden Armor
The Twins: Post-The Twins
The Destroyer: Post-The Destroyer
Skeletron Prime: Post-Skeletron Prime

Playthrough:

0: {

}
1: {
  Dead Men Tell No Tales: Post-Skeletron
  The Cavalry: Hardmode
}
2: {
  Dungeon: Dungeon
  Hallow: Hallow
  Mythril Bar: Mythril Bar
  Soul of Night: Soul of Night
}
3: {
  Bone: Bone
  Hardmode Anvil: Hardmode Anvil
  Soul of Light: Soul of Light
}
4: {
  Skeletron Prime: Post-Skeletron Prime
  The Destroyer: Post-The Destroyer
  The Twins: Post-The Twins
}